######################
#hello.world! hi back#
#  ##### #######   ###
#     # did # you use#
#######     #   ######
#  cout? ####   #yes #
#  ..,xxx+x.+b+...  .#
####cool #####   #####
   #     #####       #
####   story bro ##  #
#  #     #####   ##  #
#  #     ####    ##  #
#  #  #   #    #######
#     #   #    #     #
#######   ###  #######
      #        #      
      ##########      
