                       ###########
                    ####         ####
                 ####               ####
               ###                     ###
             ###                         ###
           ###                             ### 
          ##                                 ## 
         ##                                ### 
        ##                               ### 
       ##                              ###
       ##                            ### 
       ##                          ###
       ##                            ### 
       ##                              ### 
        ##                               ###  
         ##                                ###
          ##                                 ###
           ###                             ###
             ###                         ###
               ###                     ###
                 ####               ####
                    ####         ####
                       ###########
